{
    "default": null,
    "charMap": {
        "\u0100": "|",
        "\u00c2": ">",
        "\u0175": "&",
        "\u0102": "<",
        "\u0177": "}",
        "\u0127": "p",
        "\u03b8": "v",
        "\u00f0": "*",
        "\u0161": "$",
        "\u010e": "Z",
        "\u03c2": "E",
        "\u03b3": "g",
        "\u00fd": "Y",
        "\u00e3": "F",
        "\u0169": "N",
        "\u0129": "K",
        ".": "o",
        "\u00e1": "`",
        "\u00c4": "{",
        "p": "P",
        "c": "J",
        "v": "V",
        "g": "G"
    }
}
