{
    "default": null,
    "charMap": {
        "'": "C",
        "\u0100": "M",
        "\u00c2": "O",
        "\u0175": "W",
        "\u0102": "I",
        "\u0177": "Q",
        "\u0127": "p",
        "\u03b8": "v",
        "\u00f0": "V",
        "\u0161": "c",
        "\u010e": "Z",
        "\u03c2": "E",
        "\u03b3": "g",
        "\u00fd": "Y",
        "\u00e3": "F",
        "\u0169": "N",
        "\u0129": "K",
        ".": "o",
        "\u00e1": "e",
        "\u00c4": "L",
        "p": "P",
        "c": "J",
        "v": "B",
        "g": "G"
    }
}