{
    "default": null,
    "charMap": {
        "C": "'",
        "M": "\u0100",
        "O": "\u00c2",
        "W": "\u0175",
        "I": "\u0102",
        "Q": "\u0177",
        "p": "\u0127",
        "v": "\u03b8",
        "V": "\u00f0",
        "c": "\u0161",
        "Z": "\u010e",
        "E": "\u03c2",
        "g": "\u03b3",
        "Y": "\u00fd",
        "F": "\u00e3",
        "N": "\u0169",
        "K": "\u0129",
        "o": ".",
        "e": "\u00e1",
        "L": "\u00c4",
        "P": "p",
        "J": "c",
        "B": "v",
        "G": "g"
    }
}
