{
    "default": null,
    "charMap": {
        "C": "'",
        "M": "|",
        "O": ">",
        "W": "&",
        "I": "<",
        "Q": "}",
        "V": "*",
        "c": "$",
        "e": "`"
    }
}
