{
    "default": null,
    "charMap": {
        "C": "'",
        "M": "|",
        "Q": "}",
        "V": "*",
        "c": "$",
        "e": "`",
        "L": "{"
    }
}