{
    "default": null,
    "charMap": {
        "|": "\u0100",
        "O": "\u00c2",
        "W": "\u0175",
        "I": "\u0102",
        "}": "\u0177",
        "p": "\u0127",
        "v": "\u03b8",
        "*": "\u00f0",
        "$": "\u0161",
        "Z": "\u010e",
        "E": "\u03c2",
        "g": "\u03b3",
        "Y": "\u00fd",
        "F": "\u00e3",
        "N": "\u0169",
        "K": "\u0129",
        "o": ".",
        "`": "\u00e1",
        "{": "\u00c4",
        "P": "p",
        "J": "c",
        "V": "v",
        "G": "g"
    }
}